a -> n
b -> r
c -> ź
d -> l
e -> _
f -> m
g -> ż
h -> ę
i -> ć
j -> f
k -> e
l -> p
m -> ą
n -> u
o -> y
p -> a
q -> d
r -> i
s -> z
t -> b
u -> ó
v -> q
w -> c
x -> j
y -> w
z -> g
ą -> o
ć -> x
ę -> h
ł -> s
ń -> ł
ó -> ń
ś -> v
ż -> k
ź -> t
_ -> ś
